0 0 0 0 0 0 0 0 5 5 5 5 0 0 0 0 0 0 0 0
5 0 0 0 0 0 0 0 5 5 5 5 0 0 0 0 0 0 0 5
5 5 0 0 0 0 0 5 5 5 5 5 5 0 0 0 0 0 5 5
5 5 5 5 5 5 5 5 5 5 5 5 5 5 5 5 5 5 5 5
5 5 5 5 5 5 5 5 5 5 5 5 5 5 5 5 5 5 5 5
5 5 5 5 5 5 5 5 5 5 5 5 5 5 5 5 5 5 5 5
5 5 5 5 5 5 5 5 5 5 5 5 5 5 5 5 5 5 5 5
5 5 5 5 5 5 5 5 5 5 5 5 5 5 5 5 5 5 5 5
5 5 5 5 5 5 3 3 3 5 5 5 5 5 5 5 5 5 5 5
5 5 5 5 5 5 3 3 3 5 5 5 5 5 5 5 5 5 5 5
5 5 9 5 5 5 3 3 3 5 5 5 5 5 5 5 5 8 5 5
5 5 5 5 5 5 5 5 5 5 5 5 5 5 5 5 5 5 5 5
5 5 5 5 5 5 5 5 5 5 5 5 5 5 5 5 5 5 5 5
5 5 5 5 5 5 5 5 5 5 5 5 5 5 5 5 5 5 5 5
5 5 5 5 5 5 5 5 5 5 5 5 5 5 5 5 5 5 5 5
5 5 5 5 5 5 5 5 5 5 5 5 5 5 5 5 5 5 5 5
0 5 5 5 5 5 5 5 5 5 5 5 5 5 5 5 5 5 5 0
0 0 5 5 5 5 5 0 0 0 0 0 0 5 5 5 5 5 0 0
0 0 0 5 5 5 0 0 0 0 0 0 0 0 5 5 5 0 0 0
0 0 0 0 0 0 0 0 0 0 0 0 0 0 0 0 0 0 0 0

