1 0 0 0 0 0 0 0 0 0 0 0 0 0 0 0 0 0 0 6
2 1 0 0 0 0 0 6 0 0 0 0 1 0 0 0 0 0 6 7
0 2 1 0 0 0 6 7 0 0 0 0 2 1 0 0 0 6 7 0
0 0 2 3 3 3 7 0 0 0 0 0 0 2 3 3 3 7 0 0
0 0 0 0 0 0 0 0 0 0 0 0 0 0 0 0 0 0 0 0
0 0 0 0 0 0 0 0 0 0 0 0 0 0 0 0 0 0 0 0
0 0 0 0 0 0 0 0 0 0 0 0 0 0 0 0 0 0 0 0
0 0 0 0 0 0 0 0 0 0 0 0 0 0 0 0 0 0 0 0
0 0 0 0 0 0 0 0 0 0 0 0 0 0 0 0 0 0 0 0
0 0 0 0 0 0 0 0 0 0 0 0 0 0 0 0 0 0 0 0
0 0 0 0 0 0 0 0 0 0 0 0 0 0 0 0 0 0 0 0
0 0 0 0 0 0 0 0 0 0 0 0 0 0 0 0 0 0 0 0
0 0 0 0 0 0 0 0 0 0 0 0 0 0 0 0 0 0 0 0
0 0 0 0 0 0 0 0 0 0 0 0 0 0 0 0 0 0 0 0
0 0 0 0 0 0 0 0 0 0 0 0 0 0 0 0 0 0 0 0
1 0 0 0 0 0 0 0 0 0 0 0 0 0 0 0 0 0 0 6
2 1 0 0 0 0 0 6 3 3 3 3 1 0 0 0 0 0 6 7
0 2 1 0 0 0 6 7 0 0 0 0 2 1 0 0 0 6 7 0
0 0 2 3 3 3 7 0 0 0 0 0 0 2 3 3 3 7 0 0